x,x,x,x,x,x,x,x,x,x,x,x,x,x,x,x,x,x,x,x,x,x,x,x,x,x
x,,,,,,,,,,,,,,,,,,x,,,,,,,x
x,,,,,,,,,,,,,,,,,,x,,,,,,,x
x,,,,,,x,,,,,,,,,,,,x,,,,,,,x
x,,,,,,x,,,,,,,,,,,,x,,,,F,,,x
x,,,,,,x,,,,,,,,,,,,x,,,,,,,x
x,,,,,,x,,,,,,,,,,,,x,,,,,,,x
x,x,x,x,x,x,x,x,x,x,x,x,,,,,,,x,,,,,,,x
x,,,,,,,,,,,,,,,,,,,,,,,,,x
x,,,,,,,,,,,,,,,,,,,,,,,,,x
x,,,,,,,,,,,,,,,,,,,,,,,,,x
x,,G,,,,,,,,,,,,,,,,,,,,,,,x
x,,,,,,,,,,,,,,x,x,x,x,x,x,x,x,x,x,x,x
x,,,,,,,,,,,,,,,,,,,,,,,,,x
x,,,,,,,,,,,,,,,,,,,,,,,,,x
x,,,,,,,,,,,,,,,,,,,,,,,,,x
x,x,x,x,x,,,,x,,,,,,,,,,,,,,,,,x
x,,,,,,,,x,,,,,,,,,,,,,,,,,x
x,,,,,,,,x,x,x,x,x,x,x,,,,,,,,,,,x
x,,,,,,,,x,,,,,,,,,,,,,,,,,x
x,,,,,,,,x,,,,,,,,,,,,,,,,,x
x,,,S,,,,,x,,,,,,,,,,@,,,,,,,x
x,,,,,,,,x,,,,,,,,,,,,,,,,,x
x,,,,,,,,x,,,,,,,,,,,,,,,,,x
x,,,,,,,,x,,,,,,,,,,,,,,,,,x
x,x,x,x,x,x,x,x,x,x,x,x,x,x,x,x,x,x,x,x,x,x,x,x,x,C