x,x,x,x,x,x,x,x,x,x,x,x,x,x,x,x,x,x,x,x,x,x,x,x,x,x
x,,,,,,x,,,,,,,,,x,,,,,,,,,,x
x,,,,,,x,,,,,,,,,x,,,,,,,,,,x
x,,,F,,,x,,,,,,,,,x,,,,,,,,,,x
x,,,,,,x,,,,,,,,,x,,,,,x,x,,,,x
x,,,,,,,,,,,,,,,x,,,,,x,x,,,,x
x,,,,,,x,,,,@,,,,,x,,,,,,,,,,x
x,x,x,x,x,x,x,x,x,x,,,,,,x,,,,,,,,,,x
x,,,,,,,,,x,,,,,,x,,,,,,,,,,x
x,,,,,,,,,x,,,,,,,,,,,,,,,,x
x,,,,,,G,,,x,,,,,,,,,F,,,,,,,x
x,,,,,,,,,x,,,,,,,,,,,,,,,,x
x,,,,,,,,,x,,,,,,,,,,,,,,,,x
x,,,x,x,x,x,x,x,x,,,,,,x,x,x,x,x,x,x,x,,,x
x,,,,,,,,,,,,,,,,,,x,,,,,,,x
x,,,,,,,,,,S,,,,,,,,x,,,,,,,x
x,,,,,,,,,,,,,,,,,,x,,,,,,,x
x,,,,,,,,,,,,,,,,,,x,,,,,,,x
x,x,x,x,x,x,,,,,,,,,,,,,,,,x,,,,x
x,,,,,,,,,,x,x,x,x,x,x,,,,,,x,,,,x
x,,,,,,,,,,x,,,,,,,,,,,x,,,,x
x,,,,,,,,,,x,,,,,,,,,,,x,,,,x
x,,,,,,,,,,x,,,,,,,,,,,x,,,,x
x,,,,,,,,,,x,,,,,,,,,,,x,,,,x
x,,,,,,,,,,x,,,,,,,,,,,x,,,,x
x,x,x,x,x,x,x,x,x,x,x,x,x,x,x,x,x,x,x,x,x,x,x,x,x,x